NO ./textures/north_texture.png
SO ./textures/south_texture.png
WE ./textures/west_texture.png
EA ./textures/east_texture.png

F 192,57,43

C 52,152,219




11 1111111111 11
11 1100000011 11         
11 1100000111 11                                                                                                                                                
1111110011111111
1001000N00000001
1111111110110001
1000000000110001
1111011101001101
1111011111111101
1100000011010101
1001110001000001
1001110000000001
1100000111010101
  110111 1100101
111 1111 1111111