NO ./textures/north_texture.png
SO ./textures/south_texture.png
WE ./textures/west_texture.png
EA ./textures/east_texture.png

F 192,57,43

C 52,152,219


111111111111111111111111111111
110000000011110000000011111111
110011100011110011100000000011
111111001011000011111011110011
100100010000000000000011110011
111110111011000111111011000011
100000000011000100000011000111
111101110100110111110011000001
111101111111110111110011111101
110000001100010000000000000101
100111000100000111111011110101
100111000000N00111000000000101
110000011101010111111111110101
111011111110000100000000000101
111111111111111111111011111101
100000000000001000000011000001
111111111011111111111111101111
100000001000001000000000000001
111011101111101011101111111101
111011101111101011101111111101
100000000000001000001000000001
111111111111101111101011111111
100000000000000000001000000001
101110111011111111111011111101
101110111000000000000000000101
100000000011111111111111110101
111111111110000000000000000101
111111111111111111111111111111