NO ./textures/north_texture.png
SO ./textures/south_texture.png
WE ./textures/west_texture.png
EA ./textures/east_texture.png

F 220,100,50

C 200,110,36




111111111111111                                                               11111111
1111111111111111111111111111111111111111111111111111111111111111111111111111111111111101                      
1111100000111111111111111111111111111111111111111111111111111111111111111111111111111101                                                                                                                                                             
111111111111111111111111111111111111111111111111111111111111111111111111111111111111111
100100000000000000000000111111111                                            1111111111111111
111111111011000001110000000000001
100000000011000001110111111111111
11110111111111011100000010001
11110111111111011W101010010001
11000000110101011100000010001
10000000000000001100000010001
10000000000000001101010010001
110000011101010111110111100111
11110111 1110101 101111010001
11111111 1111111 111111111111 