NO ./textures/north_texture.png
SO ./textures/south_texture.png
WE ./textures/west_texture.png
EA ./textures/east_texture.png

F 192,57,43

C 52,152,219



11111111111111111111111111111111111111111111
10000000000011000000000000011000000000000001
10000000000011000000000000011000000000000001
10000000000011000000000000011000000000000001
10000111110011111011111111111111111111000001
10000100010000000000000000000000000001000001
10000100010000000000000000000000000001000001
11111100111111111111111011111111111111100001
10000000000000000000001000000000000000000001
10000000000000000000001000000000000000000001
11111111111111111111111111111111111111111101
10000000000000000000000000001000000000000001
10000000000000000000000000001000000000000001
10000011111111111111111111111000000000000001
10000010000000000000100000000000000011111111
10000010000000E00000100000000000000000000001
10000010000000000000100000000000000000000001
11111110000001111111111111111111111111100001
10000000000001000000000000000000000000100001
10000000000001000000000000000000000000100001
11111111111111000000000000000000000000100001
10000000000001000000011111111111111111100001
10000000000001000000010000000000000000000001
10000000000001000000010000000000000000000001
11111111111111111011110000000000000000000001
10000000000000100000000000000111111111111111
10000000000000100000000000000100000000000001
10000000000000111111111111111100000000000001
10000000000000000000000000000000000000000001
10000000000000000000000000000000000000000001
11111111111011111111111111111111111111111111
10000000001000000000000000000000000000000001
10000000001000000000000000000000000000000001
10000000001111111111111111111111111110000001
10000000000000000000000000000000000010000001
10000000000000000000000000000000000010000001
10000011111111111111111111111111111110000001
10000010000000000000000000000000000000000001
10000010000000000000000000000000000000000001
11111111111111111111111111111111111111111111