NO ./textures/north_texture.png
SO ./textures/south_texture.png
WE ./textures/west_texture.png
EA ./textures/east_texture.png

F 192,57,43

C 52,152,219




11111111111111111111111111111111111111111111
10000000000011000000000000011000000000000001
10000000000011000000000000011000000000000001
10000000000011000000000000011000000000000001
10000111110011111D11111111111111111111000001
10000100010000000000000000000000000001000001
10000100010000000000000000000000000001000001
11111100111111111111111D11111111111111000001
10000000000000000000001000000000000000000001
10000000000000000000001000000000000000000001
111D1111111111111111111111111111111111111101
1000000000000000000000000000D000000000000001
10000000000000000000000000001000000000000001
1000001111111111D111111111110000000000000011
10000010000000000000100000000000000011111111
10000010000000E00000100000000000000000000001
100000D0000000000000100000000000000000000001
11111110000001111111111111111D11111111100001
1000000000000D000000000000000000000000D00001
10000000000001000000000000000000000000100001
1111D111111111000000000000000000000000100001
1000000000000100000001111111111D111111100001
10000000000001000000010000000000000000000001
10000000000001000000010000000000000000000001
11111111111111111D11110000000000000000000001
10000000000000100000000000000111111111111111
10000000000000100000000000000100000000000001
10000000000000111111111111111100000000000001
10000000000000000000000000000000000000000001
10000000000000000000000000000000000000000001
1111D111111D11111111111111111111111111111111
10000000001000000000000000000000000000000001
10000000001000000000000000000000000000000001
10000000001111111111111111111111111110000001
100000000000000000000000000000000000D0000001
10000000000000000000000000000000000010000001
1000001111111D111111111111111111111110000001
10000010000000000000000000000000000000000001
10000010000000000000000000000000000000000001
11111111111111111111111111111111111111111111
